{
  "0": "A",
  "1": "B",
  "2": "C",
  "3": "Hello",
  "4": "L",
  "5": "O",
  "6": "ThankYou",
  "7": "V",
  "8": "Y",
  "9": "Yes"
}